#########################
#.......................#
#.......................#
#.....#...........#.....#
#.....#...........#.....#
#.....####@@@@@####.....#
.........................
.........................
.........................
......##@@@@#@@@@##......
.........................
.........................
#.......................#
#.......................#
#.....####@@@@@####.....#
#.....#...........#.....#
#.....#...........#.....#
#.......................#
#.......................#
#########################