####...####...####...####
#.......................#
#.......................#
#...#####.......@@@@@...#
#...#...............@...#
#...#...............@...#
....#...............@....
.........................
...........#@#...........
...........#@#...........
.........................
....@...............#....
#...@...............#...#
#...@...............#...#
#...@@@@@.......#####...#
#.......................#
#.......................#
#.......................#
#.......................#
####...####...####...####