...........#@#...........
.........##...##.........
........#.......#........
........#.......#........
........#.......#........
........#.......#........
........#.......#........
........#.......#........
........#.......#........
........#.......#........
........#.......#........
....####.........####....
...#...#.........#...#...
..#.....#########.....#..
..#.....#.......#.....#..
..#.....#.......#.....#..
...#...#.........#...#...
....###...........###....