#########################
.........................
.........................
.........................
.........................
.........................
.@@.@@..@@.@@@@@@.@@@@@@.
.@@.@@..@@.@@..@@.@@..@@.
.@@.@@@@@@.@@@@@@.@@@@@@.
.@@.@@@@@@.@@@@@@.@@@@@@.
.@@.....@@.@@..@@.@@..@@.
.@@.....@@.@@@@@@.@@@@@@.
.........................
.........................
.........................
.........................
.........................
.........................
.........................
#########################