.........................
.........................
.........................
.........................
.........................
......@@@@@@@@@@...@.....
......@@@@@@@@@@...@.....
......@@######@@...@.....
......@@######@@...@.....
......@@######@@...@.....
......@@######@@...@.....
......@@######@@...@.....
......@@######@@...@.....
......@@@@@@@@@@..@@.....
......@@@@@@@@@@..@......
.........................
.........................
.........................
.........................
.........................
