.........................
.........................
......######....#####....
.....########..######....
.....########.#######....
.....################....
.....################....
.....###############.....
.....###############.....
.....###############.....
......#############......
.......############......
.......############......
........##########.......
.........########........
..........######.........
...........####..........
............#............
.........................
.........................
