.........................
.........................
.........................
......@@@@@@@@@@@@.......
......@..........@.......
......@..........@.......
......@..######..@.......
......@..........@.......
......@..........@.......
......@@@@@@@@@@@@.......
.........................
.........................
.........................
.........................
.........................
.........................
.........................
.........................
.........................
.........................
